111111111111
1E0000000101
101001010101
101001000C01
1P00000C0101
111111111111