111111111111
10000000E001
100C00000001
10000C0000P1
111111111111