111111111111
1P100100C001
100100010011
10C0001E00C1
111111111111