111111111111
10000000E001
100C00000001
1000000000P1
111111111111