1111111111111111111111111111111
1000000000000000000001000000001
100000000C000000000001P00000001
1000000000000000000001110000001
1000001111100000000000010000001
1000000C00100C0000000E010000001
1000000000100000000000000000001
1111111111111111111111111111111