11111111111111111111
10000000C01100000001
1111E0000C11C1001001
11000011111111001001
11110000000000000P01
11111111111111111111