1111111111111111111
1000C00000000000001
1000000000E00000001
1000000000000000P01
1111111111111111111